elder brother - старший брат;
worse - хуже;
youngest son - младший сын;
reliable - надежный;
exact - точный;
least - наименьший
strict - строгий
previos - предыдущий
pretty - милая;
old - старый;
pregnant - беременная;
famous (for) - известный;
economic - экономический;
smart - умный;
fast - быстрый;
other - другие;
gold - золотой;
kind - добрый;
successful - упешный;
another - другой;
ill - больной;
sorry - жаль;
yellow - желтый;
daily - ежедневный;
wide - широкий;
interesting - интересный;
standard - стандартный;
direct - прямой;
personal - персональная, личная;
religious - религиозный;
mobile - мобильный;
kind - добрый;
positive - позитивный; 
silver - серебренный;
brown - коричневый;
boring - скучный;
right - правильный;
serious - серьёзная;
each - друга;
academic - академический;
confident - уверенный;
pleasant - приятный;
ancient - древний;
natural - натуральный;
huge - огромный;
social - социальный;
leather - кожанный;
real - настоящий;
interested - заинтересован;
mad - сумасшедший;
dry - сухой;
financial - финансовый;
crazy - сумасшедший;
excellent - отличный;
unique - уникальная;
warm - теплый;
exact - точный;
creative - креативный;
correct - првильный;
clear - понятный, чистый;
sudden - внезапное;
educational - образовательный;
sweet - сладкий;
technical - техническая;
rare - редкий;
sick - больной;
glad - рад;
tired - уставший;
negative - отрицательный;
friendly - дружелюбный;
green - зеленая;
ready - готов;
happy - рад;
white - белый;
surprised - удивлен;
busy - занят;
big - больше;
dead - мертвый;
short - короткий;
low - гораздо;
terrible - ужасный;
left - лево;
impossible - невозможно;
possible - возможно;
bitter - горькое;
empty - пустой;
single - холостой;
final - финальный;
illegal - незаконный;
nice - милый;
special - специальная;
worried - взволнован, обеспокоин;
small - поменьше, маленький;
angry - злой;
professional - профессиональные;
ordinary - обычная;
informal - неофициальный;
loud - громче;
full - полный;
regular - правильный;
difficult - сложная;
funny - смешной;
deep - глубокий;
patient - терпеливый;
new - новый;
safe - ьезопастный;
popular - популярный;
wise - мудрая;
broad - широкие;
perfect - идеальный;
unhappy - несчастной;
national - национальный;
rich - богатый;
sure - уверен;
foreign - иностранный;
total - общий;
favourite - любимый;
dirty - грязный;
exciting - захватыващий;
powerful - мощный;
different - разные;
grey BrE( gray AmE);
little - маленький;
common - распространенный;
suspicious - подозрительный;
strong - сильный;
dangerous - опасный;
agresssive - агрессивный;
formal - формальный;
long - длинный;
valuable - ценный;
cheap - дешевый;
open - открытый;
obvious - очевижный;
hot - жаркий;
brave - храбрый;
large - большой;
wrong - неправильный;
fine - прекрасный;
sad - грустный;
local - местный;
silly - глупый;
cold - холодный;
dark - темно;
hungry - голодный;
necessary - необходимый;
narrow - узкая;
commercial - коммерческий;
healthy - здоровый;
simple - простой;
proud - гордишься;
recent - замечательный;
true - настояший;
certain - уверен;
maim - главный;
quiet - тихом;
specific - определенный;
late - опоздавший;
important - важный;
tall - высокий;
absent - отсутствующий;
thin - худой;
stupid - глупый;
slim - стройный;
unusual - необычный;
honest - честный;
beautiful - красивый;
frequent - частый, частотный;
weak - слабый ;
previous - предыдущий;
official - официальный;
light - светлый;
intelligent - умный, интелегент;
complex - сложный;
basic - базовый;
amazing - потрясающий;
cool - классный;
married - женатый;
slow - медленный;
comfortable - удобный;
useful - полезный;
heavy - тяжелый;
typical (of) - типично;
great - отличная;
uncomfortable - неудобный;
free - свободный;
clean - чистый;
hign - высокий;  
poor - бедный;
guilty - виновный;
false - ложный;
active - активный;
present - присутствовать;
easy - легкий;
following - следующий;
scientific - научный;
young - моложе;
far - далекий, далеко;
