deliver - доставлять;
delay - задержать;
lay / laid / laid - положить, класть;
sell / sold / sold - продавать;
come / came / come - приходить;
agree - соглашаться;
open - открыть;
grow (up) / grew / grown - вырасти (о людях) где-то;
multiply - умножать;
exist - существовать;
resolve - разрешить;
frighten - напушать;
show / showed / shown - показать;
get / got / got - получать;
bite / bit / bitten - укусить;
beat / beat / beaten - побить, избить;
kick - пнуть;
climb up - взобраться на;
ride / rode / ridden - кататься;
delete - удалять;
lose / lost / lost - проиграть;
hurt / hurt / hurt - ушибить, ранить;
decrease - снизить;
forget / forgot / forgotten - забыть;
argue - спорить;
disappear - исчезать;
lend / lent / lent - отдолжить;
mean / meant / meant - означать;
buy / bought / bought - покупать;
notice - заметить;
measure - измерять;
sit / sat /sat - сидеть;
walk - гулять;
depend - зависить;
would - бы;
translate from ... into - переводить;
read / read / read - читать;
reach - достичь;
communicate - общаться;


clean - убирать;
run / ran / run - бежать;
deny - отвергать;
win / won / won - побеждать;
join - вступить, присоединиться;
sing / sang/ sung - петь;
supply - поставлять;
improve - улучшить;
spell, spelt, spelt - писать;
dislike - не нравится;
warn - предупредить;
kiss - целовать;
shout (at) - кричать (на когото);
influence - влиять;
record - записать;
ignore - игнорировать;
break, broke, broken - ломать;
put, put, put - положить, ставить;
shave, shave, shave - сбрить;
swim, swam, swum - плавать;
touch - трогать;
concern - касаться;
develop - развивать;
eat , ate , eaten - есть;
imagine - представить;
follow - следовать, последовать;
damage - нанести вред;
blow, blew, blown - дуть, подуть;
leave, left, left - уйти, оставлять, уезжать;
appear - появляться, казаться;
create - создавать;
solve - решить проблему, задачу;
fail - провалить, заволить;
work - работа, работать;
jump - прыгнуть;
hunt - охотиться;
receive - получать;
wish - пожелать;
begin, began, begun - начинать;
go, went, gone - ходить;
breathe in / out - вдохнуть;
concentrate - сосредоточиться;
control - контролировать;
wait - ждать;
fix - исправлять;
stop - прекратить, остановиться;
believe - верить, поверить;
order - заказывать;
need - нуждаться;
click / press the button - нажать;
dig, dug, dug - рыть, копать;
scan - отсканировать;
book - забронировать;
make, made, made - сделать;
find, found, found - нахожу, находить;
invite to - приглашать;
fight, fought, fought - сражаться;
wear, wore, worn  - носить;
pay, paid, paid - заплатить;
try - пытаться, стараться;
punish - наказывать;
shine - светить;
happen - случаться;
enter - войти;
draw, drew, drawn - рисовать;
train - тренироваться;
compare - сравнивать;
install - устанавливать;
escape - сбежать;
use - использовать;
type - печатать;
include - включать;
exists - существовать:
