scenario - сценарий;
season - сезон;
yours - твой, ваш;
procedure - процедура;
fence - забор;
set up - устанавливать;
both - обе вещи;
accuse - обвинять;
oil - нефть, масло;
gas - газ;
significantly - значительно;
angrily - сердито;
speech - речь;
guilt - вина;
moustache - усы;
wires - провода;
arm - рука;
each of us - каждого из нас;
beard - борожа;
for the first time - в первый раз;
at present - в настояещее время; 
the suburbs - пригороде;
in trouble;
I was very pleased - мне было очень приятно;
I was absolutely delighted - Я был в полном восторге;
impatience - нетерпение;
a hole - яма;
in advance - заранее;
attractive - привлекательный;
below - ниже;
several - несколько;
because of - из-за;
the criminals - преступники;
greatest - величайшая;
lately - в последнее время;
the quipment - оборудование;
properly - правильно;
on a regular basis - на регулярной основе;
aunt - тетя;
baggage - багаж;
balcony - балкон;
bear - медведь;
chicken - курица;
crocodile - крокодил;
dining room - столовая;
dirt - грязь;
fridge - холодильник;
garage - гараж;
calculater - кальулятор;
carpet - ковер;
intention - намерение;
literature - литература;
rollerblades - роликовые коньки;
rug - ковер;
similar - похожий;
skateboard - скейтбоард;
mistaken - ошибаться;
regret - сожалеть;
basis - основа;
ladder - лестница; 
unnecessary - ненужный;