typical of - типично для;
jealous of - ревнует кого-то;
good at - хорош в чем-то;
responsible for - ответственный за;
keen on - увлекаться чем-то;
prepared for - готов к;
ready for - готов к;
related to - связанный с;
connected with - связанный с;
terrible at - ужасен в;
familiar to - что-то знакомо кому-то;
familiar with - Кому-то знакомо что-то;
shocked by / at - шокирован чем-то;
angry with someone - зол на кого-то;
angry about something - зол на что-то;
anxious about - обеспокоен чем-то;
excellent at - отлично в чем-то;
used to - привык к;
accused of - обвинили в;
angry about something - зол на что-то (изза чего-то);
surprised by / at - удивлен чем-то;
impressed by / with - впечатлен чем-то;
tired of - устал что-то;
worried about - взволновон чем-то;
bad at - плох в чем-то;
similar to - похож с;
sensitive to - чувствителен к;
incapable of - не способен;
afraid of - бояться чего-то;
associated with - ассоциируется с;
accustomed to doing - привыкнуть к;
fed up with - сыт по горло; 
capable of - способен что-то сделать;
married to - замужем за;
guilty of - виновен в;
aware of - осведовлен о;
ashamed of - стыдно за;
harmful to - вредно для;
selfish of - эгоистично с;
busy with - занят чем-то;
cruel of - жестоко с;
happy about - рад чему-то;
amazed by - поражен чем-то;
careful with - осторожным с;
inspired by - вдохновлен;
enthusiastic about - увлечен чем-то;
wrong with - не так с;
successful in - успешен в;
crowded with - переполнен;
satisfied with - удовлетворен чем-то;
friendly with - дружелюбен с;
suitable for - подходит для;
cruel to - жесток с;
scared of - бояться чего-то;
dissatified with - недоволен, неудовлетворен;
